-----------------------------
00000000000000000000000000000
00000000000000000000000000000
00211111111111111111111111200
00100000010000100001000000100
00100000010000100001000000100
00100111111111111111111100100
00100100000100000100000100100
00100100000100000100000100100
00111100111111111111100111100
00100100100100100100100100100
00100111100100100100111100100
00100100100100100100100100100
00100100100100100100100100100
00100111100100100100111100100
00100100100100100100100100100
00111100111111111111100111100
00100100000100000100000100100
00100100000100000100000100100
00100111111111111111111100100
00100000010000100001000000100
00100000010000100001000000100
00211111111111111111111111200
00000000000000000000000000000
00000000000000000000000000000