-----------------------------
00000000000000000000000000000
00000000000000000000000000000
00111111111111111111111111100
00100001000100100100010000100
00100001000100100100010000100
00100111000100100100011100100
00100100000100100100000100100
00111100000100100100000111100
00100000111111111111100000100
00100000100100100100100000100
00111111100100100100111111100
00100000100100100100100000100
00100000100100100100100000100
00111111100100100100111111100
00100000100100100100100000100
00100000111111111111100000100
00111100000100100100000111100
00100100000100100100000100100
00100111000100100100011100100
00100001000100100100010000100
00100001000100100100010000100
00111111111111111111111111100
00000000000000000000000000000
00000000000000000000000000000